Break Out!
000000000000000
000000000000000
111111111111111
111111111111111
111111111111111
111111111111111
000000000000000
000000000000000
000000000000000
000000000000000
0.15  
0.45 
0.005 
Back Alley
000000000000000
111101111101111
112101121101211
112101121101211
111101111101111
000000000000000
000000000000000
000000000000000
000000000000000
000000000000000
0.20  
0.50  
0.005 
Denial
111111111111111
000000000000000
112211222112211
000000000000000
111111111111111
000000000000000
111122111221111
000000000000000
000000000000000
000000000000000
0.25  
0.55  
0.005
Anger
010010010020010
001001002001001
100100200100100
010020010010020
002001001002001
200100100200100
000000000000000
000000000000000
000000000000000
000000000000000
0.30
0.60  
0.008 
Bar Code
041021020120130
041021020120130
041021020120130
041021020120130
041021020120130
041021020120130
000000000000000
000000000000000
000000000000000
000000000000000
0.30
0.60  
0.008 
The Launcher
000000000000000
000000111000000
000111111111000
011111111111110
111111111111111
000000111000000
000000111000000
000022222220000
000000000000000
000000000000000
0.35  
0.65  
0.01 
Superball
000000000000000
000000111000000
000011000110000
001100020001100
001100222001100
001100020001100
000011000110000
000000111000000
000000000000000
000000000000000
0.40  
0.70  
0.01
Rings of Saturn
110000000000011
111000000000111
021110000011120
000211111112000
000000121000000
110000000000011
112000000000211
011120000021110
000111212111000
000000111000000
0.40
0.70
0.01
Tie Fighter
210000000000012
210000111000012
210011101110012
210110000011012
211100020001112
211100202001112
210110000011012
210011101110012
210000111000012
210000000000012
0.45
0.73
0.012
The Belt Tightener
220000000000022
220000111000022
220000000000022
220011111110022
220000000000022
226666666666622
220000000000022
220011111110022
220000000000022
222220111022222
0.45
0.75
0.015
Slim Pickins
000000000000000
112221122211222
000000000000000
000000000000000
122211222112221
000000000000000
000000000000000
222112221122211
000000000000000
000000000000000
0.45
0.75
0.02
Break Time
000000000000000
111134111341111
111111111111111
113411111113411
111111111111111
111134111341111
000000000000000
000000000000000
000000000000000
000000000000000
0.15
0.75
0.01
I Hear ya Knockin'
000000000000000
006666666666600
003000000000400
003000050000400
003000314000400
003000060000400
003000000000400
005555555555500
000000000000000
000000000000000
0.40
0.75
0.01
Shaken not Stirred
000000000000000
000051111150000
000005111500000
000000515000000
000000030000000
000000040000000
000000030000000
000000040000000
000000030000000
000005555500000
0.40
0.75
0.01
Anne!
000000000000000
050600630034440
505660633034000
555666633334440
505606630334000
505600630034440
000000000000000
111111111111111
111111111111111
111111111111111
0.55
0.70
0.01
Teepee
000003000400000
000000304000000
000000060000000
000000463000000
000004463300000
000044463330000
000444463333000
004444403333300
044444000333330
4444400000333331
0.55
0.70
0.01
Yeah!
000000000000000
101011100100101
101010001010101
020012001210121
010010001010101
010011101010101
000000000000000
111111111111111
000000000000000
000000000000000
0.60
0.90
0.02
In your Face
000000000000000
000000000000000
000000000000000
000000050000000
000000000000000
000000000000000
221122112211221
111111111111111
112211221122112
111111111111111
0.50
0.75
0.01
Happy Family
000000000000000
011100111001110
012100121001210
011100111001110
001000010000100
111111111111111
001000050000100
016100555001610
010105555501010
010100101001010
0.50
0.80
0.015
Happy Family II
000000000000000
011100111001110
012100121001210
011100111001110
001000010000100
111111111111111
004000010000300
044400151003330
444440101033333
010100101001010
0.50
0.80
0.015
The Orb
000000000000000
000000050000000
000005555500000
000055555550000
000555555555000
000111111111000
000666666666000
000066666660000
000006666600000
000000060000000
0.50
0.80
0.015